72 30
111111111111111111111111111111111111111111111111111111111111111111111111
1@1000100000000000000000000000000000000000000000000000000000000000000001
101010100000000000000000000000000000000000000000000000000000000000000001
100010100000000000000000000000000000000000000000000000000000000000000001
111110100000000000000000000000000000000000000000000000000000000000000001
100000000000000000000000000000000000000000000000000000000000000000000001
100000000000000000000000000000000000000000000000000000000000000000000001
100000000000000000000000000000000000000000000000000000000000000000000001
100000000000000000000000000000000000000000000000000000000000000000000001
100000000000000000000000000000000000000000000000000000000000000000000001
100000000000000000000000000000000000000000000000000000000000000000000001
100000000000001101000000000000000000000000000000000000000000000000000001
100000000000110000110000000000000000000000000000000000000000000000000001
100000000001000000001000000000000000000000000000000000000000000000000001
100000000001000100001000000000000000000000000000000000000000000000000001
100000000000111001110000000000000000000000000000000000000000000000000001
100000000000100000010000000000000000000000000000000000000000000000000001
100000000000100000010000000000000000000000000000000000000000000000000001
100000000000100000010000000000000000000000000000000000000000000000000001
100000000000100000010000000000000000000000000000000000000000000000000001
100000000000100000010000000000000000000000000000000000000000000000000001
100000000000100000010000000000000000000000000000000000000000000000000001
100000000000100000010000000000000000000000000000000000000000000000000001
100000000011110000111100000000000000000000000000000000000000000000000001
100000001100000110000011000000000000000000000000000000000000000000000001
100000001000000110000001000000000000000000000000000000000000000000000001
100000001100001111000011000000000000000000000000000000000000000000000001
100000000011110000111100000000000000000000000000000000000000000000000001
100000000000000000000000000000000000000000000000000000000000000000000001
111111111111111111111111111111111111111111111111111111111111111111111111
