20 10
11111111111111111111
10000000111000001101
10000000000011100001
10000000000010100011
10010010010000000011
1@000000000110011011
10000000000110100001
10010000100001000001
11111111000111111101
11111111111111111111
