20 9
11111111111111111111
10000000000000000001
10000000000000000001
10000001000000000001
10000000100000000111
10000001000000000001
1000000000@000000001
10000000000000000001
11111111111111111111
