20 9
11111111111111111111
1@001000100000000001
11101010100000000001
10000010100000000001
10111110000000000111
10000000100100000001
11111111100010000001
10000000000100000001
11111111111111111111
