5 5
11111
10001
1@001
10001
11111
