5 5
11111
11011
10001
11011
11111
