5 5
11111
11011
1@001
11011
11111
