10 11
1111111111
1000000001
1000000001
1111111001
1001111001
1@00000001
1001000011
1000000101
1000000001
1000000001
1111111111
