5 5
11111
11011
10@01
11011
11111
